NO ./extra/textures/brick_2.xpm
SO ./extra/textures/brick_2.xpm
WE ./extra/textures/brick_2.xpm
EA ./extra/textures/brick_2.xpm
F 220,100,0
C 225,30,0

1111111111111111111111111111111111111111111111111111111111111111111111111111111111111111111111111111111111111111111111111111111111111111111111111111111111111111111111111111111111111111111111111111111111111111111111111111111111111111111111111111111111111
1000000000000000000000000000000000000000000000000000000000000000000000000000000000000000000000000000000000000000000000000000000000000000000000000000000000000000000000000000000000000000000000000000000000000000000000000000000000000000000000000000000000001
1000000000000000000000000000000000000000000000000000000000000000000000000000000000000000000000000000000000000000000000000000000000000000000000000000000000000000000000000000000000000000000000000000000000000000000000000000000000000000000000000000000000001
1000000000000100000000000010000000000001000000000000100000000000010000000000001000000000000100000000000010000000000001000000000000100000000000010000000000001000000000000100000000000010000000000001000000000000100000000000010000000000001000000000000100001
1000000000000100000000000010000000000001000000000000100000000000010000000000001000000000000100000000000010000000000001000000000000100000000000010000000000001000000000000100000000000010000000000001000000000000100000000000010000000000001000000000000100001
1000000000000100000000000010000000000001000000000000100000000000010000000000001000000000000100000000000010000000000001000000000000100000000000010000000000001000000000000100000000000010000000000001000000000000100000000000010000000000001000000000000100001
1000000000000100000000000010000000000001000000000000100000000000010000000000001000000000000100000000000010000000000001000000000000100000000000010000000000001000000000000100000000000010000000000001000000000000100000000000010000000000001000000000000100001
1000000000100100000000100010000000010001000000001000100000000100010000000010001000000001000100000000100010000000010001000000001000100000000100010000000010001000000001000100000000100010000000010001000000001000100000000100010000000010001000000001000100001
1000000001000100000000100010000000010001000000001000100000000100010000000010001000000001000100000000100010000000010001000000001000100000000100010000000010001000000001000100000000100010000000010001000000001000100000000100010000000010001000000001000100001
1000000001000100000000100010000000010001000000001000100000000100010000000010001000000001000100000000100010000000010001000000001000100000000100010000000010001000000001000100000000100010000000010001000000001000100000000100010000000010001000000001000100001
1000000001000100000000100010000000010001000000001000100000000100010000000010001000000001000100000000100010000000010001000000001000100000000100010000000010001000000001000100000000100010000000010001000000001000100000000100010000000010000000000001000000001
1000000001000000000000100000000000010000000000001000000000000100000000000010000000000001000000000000100000000000010000000000001000000000000100000000000010000000000001000000000000100000000000010000000000001000000000000100000000000010000000000001000000001
1000000001000000000000100000000000010000000000001000000000000100000000000010000000000001000000000000100000000000010000000000001000000000000100000000000010000000000001000000000000100000000000010000000000001000000000000100000000000010000000000001000000001
1000000001000000000000100000000000010000000000001000000000000100000000000010000000000001000000000000100000000000010000000000001000000000000100000000000010000000000001000000000000100000000000010000000000001000000000000100000000000010000000000001000000001
1000000001000000000000100000000000010000000000001000000000000100000000000010000000000001000000000000100000000000010000000000001000000000000100000000000010000000000001000000000000100000000000010000000000000000000000000000000000000000000000000000000000001
1000000000000000000000000000000000000000000000000000000000000000000000000000000000000000000000000000000000000000000000000000000000000000000000000000000000000000000000000000000000000000000000000000000000000000000000000000000000000000000000000000000000001
1000000000000000000000000000000000000000000000000000000000000000000000000000000000000000000000000000000000000000000000000000000000000000000000000000000000000000000000000000000000000000000000000000000000000000000000000000000000000000000000000000000000001
1000000000000000000000000000000000000000000000000000000000000000000000000000000000000000000000000000000000000000000000000000000000000000000000000000000000000000000000000000000000000000000000000000000000000000000000000000000000000000000000000000000000001
1000000000000000000000000000000000000000000000000000000000000000000000000000000000000000000000000000000000000000000000000000000000000000000000000000000000000000000000000000000000000000000000000000000000000000000000000000000000000000000000000000000000001
1000000000000000000000000000000000001111111111111111111111111111111111111111111111111111111100000000000000000000000000000000000000000000000000000000000000000000000000000000000000000000000000000000000000000000000000000000000000000000000000000000000000001
1000000000000000000000000000000000000000000000000000000000000000000000000000000000000000000000000000000000000000000000000000000000000000000000000000000000000000000000000000000000000000000000000000000000000000000000000000000000000000000000000000000000001
1000000000000000000000000000000000000000000000000000000000000000000000000000000000000000000000000000000000000000000000000000000000000000000000000000000000000000000000000000000000000000000000000000000000000000000000000000000000000000000000000000000000001
1000000000000000000000000000000000000000000000000000000000000000000000000000000000000000000000000000000000000000000000000000000000000000000000000000000000000000000000000000000000000000000000000000000000000000000000000000000000000000000000000000000000001
1000000000000000000000000000000000000000000000000000000000000000000000001111111111111111111111111111111111111111111111111111111100000000000000000000000000000000000000000000000000000000000000000000000000000000000000000000000000000000000000000000000000001
1000000000000000000000000000000000000000000000000000000000000000000000000000000000000000000000000000000000000000000000000000000000000000000000000000000000000000000000000000000000000000000000000000000000000000000000000000000000000000000000000000000000001
1000000000000000000000000000000000000000000000000000000000000000000000000000000000000000000000000000000000000000000000000000000000000000000000000000000000000000000000000000000000000000000000000000000000000000000000000000000000000000000000000000000000001
1000000000000000000000000000000000000000000000000000000000000000000000000000000000000000000000000000000000000000000000000000000000000000000000000000000000000000000000000000000000000000000000000000000000000000000000000000000000000000000000000000000000001
1000000000001000000000001000000000000100000000000010000000000001000000000000100000000000010000000000001000000000000100000000000010000000000001000000000000100000000000010000000000001000000000000100000000000010000000000001000000000000100000000000010000001
1000000000010000000000001000000000000100000000000010000000000001000000000000100000000000010000000000001000000000000100000000000010000000000001000000000000100000000000010000000000001000000000000100000000000010000000000001000000000000100000000000010000001
1000000000010000000000001000000000000100000000000010000000000001000000000000100000000000010000000000001000000000000100000000000010000000000001000000000000100000000000010000000000001000000000000100000000000010000000000001000000000000100000000000010000001
1000000000010000000000001000000000000100000000000010000000000001000000000000100000000000010000000000001000000000000100000000000010000000000001000000000000100000000000010000000000001000000000000100000000000010000000000001000000000000100000000000010000001
1000000000010000000000001000000000000100000000000010000000000001000000000000100000000000010000000000001000000000000100000000000010000000000001000000000000100000000000010000000000001000000000000100000000000010000000000001000000000000100000000000010000001
1000000000010000000000001000000000000100000000000010000000000001000000000000100000000000010000000000001000000000000100000000000010000000000001000000000000100000000000010000000000001000000000000100000000000010000000000001000000000000100000000000010000001
1000000000010000000000001000000000000100000000000010000000000001000000000000100000000000010000000000001000000000000100000000000010000000000001000000000000100000000000010000000000001000000000000100000000000010000000000001000000000000100000000000010000001
1000000000010000000000001000000000000100000000000010000000000001000000000000100000000000010000000000001000000000000100000000000010000000000001000000000000100000000000010000000000001000000000000100000000000000000000000000000000000000000000000000000000001
1000000000000000000000000000000000000000000000000000000000000000000000000000000000000000000000000000000000000000000000000000000000000000000000000000000000000000000000000000000000000000000000000000000000000000000000000000000000000000000000000000000000001
1000000000000000000000000000000000000000000000000000000000000000000000000000000000000000000000000000000000000000000000000000000000000000000000000000000000000000000000000000000000000000000000000000000000000000000000000000000000000000000000000000000000001
1000000000000000000000000000000000000000000000000000000000000000000000000000000000000000000000000000000000000000000000000000000000000000000000000000000000000000000000000000000000000000000000000000000000000000000000000000000000000000000000000000000000001
1000000000000000000000000000000000000000000000000000000000000000000000000000000000000000000000000000000000000000000000000000000000000000000000000000000000000000000000000000000000000000000000000000000000000000000000000000000000000000000000000000000000001
1000000000000000000000000000000000000000000000000000000000000000000000000000000000000000000000000000000000000000000000000000000000000000000000000000000000000000000000000000000000000000000000000000000000000000000000000000000000000000000000000000000000001
1000000000000000000000000000000000000000000000000000000000000000000000000000000000000000000000000000000000000000000000000000000000000000000000000000000000000000000000000000000000000000000000000000000000000000000000000000000000000000000000000000000000001
1000000000000000000000000000000000000000000000000000000000000000000000000000000000000000000000000000000000000000000000000000000000000000000000000000000000000000000000000000000000000000000000000000000000000000000000000000000000000000000000000000000000001
1000000000000000000000000000000000000000000000000000000000000000000000000000000000000000000000000000000000000000000000000000000000000000000000000000000000000000000000000000000000000000000000000000000000000000000000000000000000000000000000000000000000001
1S00000000000000000000000000000000000000000000000000000000000000000000000000000000000000000000000000000000000000000000000000000000000000000000000000000000000000000000000000000000000000000000000000000000000000000000000000000000000000000000000000000000001
1111111111111111111111111111111111111111111111111111111111111111111111111111111111111111111111111111111111111111111111111111111111111111111111111111111111111111111111111111111111111111111111111111111111111111111111111111111111111111111111111111111111111
